g;g;g;g;g;g;g;g;g;t;g;g;g;g;g
g;g;g;g;g;g;g;g;g;g;g;g;g;g;g
s;r;r;r;r;r;r;r;r;r;r;r;g;g;g
g;g;g;g;g;g;g;g;g;g;g;r;g;g;g
g;g;g;g;g;g;g;g;g;g;g;r;g;g;g
g;g;g;g;g;g;g;g;g;g;g;r;g;g;g
g;g;r;r;r;r;r;r;r;r;r;r;g;g;g
g;g;r;g;g;g;g;g;g;g;g;g;g;g;g
g;g;r;g;g;g;t;g;g;g;g;g;g;g;g
g;g;r;g;g;g;g;g;g;g;g;g;g;g;g
g;g;r;g;g;g;g;g;g;g;g;g;t;g;g
g;g;r;g;g;g;g;g;g;g;g;g;g;g;g
g;g;r;r;r;r;r;r;r;r;r;r;r;r;e
g;g;g;t;g;g;g;g;g;g;g;g;g;g;g
g;g;g;g;g;g;g;g;g;g;g;g;g;g;g