g;g;g;g;g;g;g;g;g;g;g;g;g;g;g
g;g;g;g;g;g;g;g;g;g;g;g;g;g;g
s;r;r;r;r;r;r;r;r;r;r;r;g;g;g
g;g;g;g;g;g;g;g;g;g;g;r;g;g;g
g;g;g;g;g;g;g;g;g;g;g;r;g;g;g
g;g;g;g;g;g;g;g;g;g;g;r;g;g;g
g;g;r;r;r;r;r;r;r;r;r;r;g;g;g
g;g;r;g;g;g;g;g;g;g;g;g;g;g;g
g;g;r;g;g;g;g;g;g;g;g;g;g;g;g
g;g;r;g;g;g;g;g;g;g;g;g;g;g;g
g;g;r;g;g;g;g;g;g;g;e;g;g;g;g
g;g;r;g;g;g;g;g;g;g;r;g;g;g;g
g;g;r;r;r;r;r;r;r;r;r;g;g;g;g
g;g;g;g;g;g;g;g;g;g;g;g;g;g;g
g;g;g;g;g;g;g;g;g;g;g;g;g;g;g